X X X X X X X X X X
X . X . . . X X . X
X . X . X . X X . X
X . X . X . X X . X
X . . . X . . X . X
X X X . X X X X . X
X . X . X . . . . X
X . X . X . X X X X
X . . J . . . . . X
X X X X X X X X X X
