XXXXXXXXXX
X.X...XX.X
X.X.X.XX.X
X.X.X.XX.X
X...X..X.X
XXX.XXXX.X
X.X.X....X
X.X.X.XXXX
X..J.....X
XXXXXXXXXX
