1 1 1 1 1 1 1 1 1 1 1 1 1 1 1 1 1 1 1 4
2 0 0 0 0 0 0 0 0 0 0 0 0 0 0 0 0 0 0 4
2 0 0 0 0 0 0 0 0 0 0 0 0 0 0 0 0 0 0 4
2 0 0 0 0 0 0 0 0 0 0 0 0 0 0 0 0 0 0 4
2 0 0 0 0 0 0 0 0 0 0 0 0 0 0 0 0 0 0 4
2 0 0 0 0 0 0 0 0 0 0 0 0 0 0 0 0 0 0 4
2 0 0 0 0 0 0 0 0 0 0 0 0 0 0 0 0 0 0 4
2 0 0 0 0 0 0 0 0 0 0 0 0 0 0 0 0 0 0 4
2 0 0 0 0 0 0 0 0 0 0 0 0 0 0 0 0 0 0 4
2 0 0 0 0 0 0 0 0 0 0 0 0 0 0 0 0 0 0 4
2 0 0 0 0 0 0 0 0 0 0 0 0 0 0 0 0 0 0 4
2 0 0 0 0 0 0 0 0 0 0 0 0 0 0 0 0 0 0 4
2 0 0 0 0 0 0 0 0 0 0 0 0 0 0 0 0 0 0 4
2 0 0 0 0 0 0 0 0 0 0 0 0 0 0 0 0 0 0 4
2 0 0 0 0 0 0 0 0 0 0 0 0 0 0 0 0 0 0 4
2 0 0 0 0 0 0 0 0 0 0 0 0 0 0 0 0 0 0 4
2 0 0 0 0 0 0 0 0 0 0 0 0 0 0 0 0 0 0 4
2 0 0 0 0 0 0 0 0 0 0 0 0 0 0 0 0 0 0 4
2 0 0 0 0 0 0 0 0 0 0 0 0 0 0 0 0 0 0 4
2 3 3 3 3 3 3 3 3 3 3 3 3 3 3 3 3 3 3 3
