7 7 7 -1 7 7 7 7 7 7 7 1 1 1 1 1 1 1 1 1 1 1 1 1 1 1 1 1 1 1 1 1 1 1 1 1 1 1 1 1 1 1
7 7 7 -1 7 7 7 7 7 7 7 1 1 1 1 1 1 1 1 1 4 4 4 4 4 4 4 4 4 4 4 4 4 4 4 4 4 4 4 4 4 4
7 7 0 0 7 0 0 0 0 0 7 0 0 0 9 9 0 0 0 0 0 0 0 0 0 0 0 0 0 0 0 0 0 0 0 0 4 0 0 0 4 4
7 7 0 0 7 0 0 0 0 0 7 0 0 0 9 9 0 0 0 0 0 0 0 0 0 0 0 0 0 0 0 0 0 0 0 0 0 0 0 0 4 4
7 7 0 0 0 0 0 0 0 0 0 0 0 0 9 9 0 0 0 0 4 4 4 4 4 4 4 4 4 4 4 4 4 4 0 0 0 0 0 0 4 4
7 7 0 0 0 0 0 0 0 0 0 0 0 0 9 9 0 0 0 0 4 4 0 0 0 0 0 0 0 0 0 0 0 4 0 0 4 4 4 4 4 4
7 7 0 0 7 0 0 0 0 0 7 0 0 0 0 0 0 0 0 0 4 4 0 0 0 0 0 0 0 0 0 0 0 4 4 4 4 0 0 0 4 4
7 7 0 0 7 7 7 7 7 7 7 0 0 0 0 0 0 0 0 0 4 4 0 0 0 0 0 0 0 0 0 0 0 0 0 0 0 0 0 0 4 4
7 7 0 0 7 0 0 0 0 0 7 0 0 0 0 0 0 0 0 0 4 4 0 0 0 4 0 0 0 0 0 0 0 0 0 0 0 0 0 0 4 4
7 7 0 0 7 0 0 0 0 0 0 0 0 0 9 9 0 0 0 0 0 0 0 0 0 4 0 0 0 0 0 0 0 2 2 2 2 2 0 0 4 4
7 7 0 0 7 0 0 0 0 0 0 0 0 0 9 9 0 0 0 0 0 0 0 0 0 4 0 0 4 0 0 0 0 0 0 0 0 2 0 0 4 4
7 7 0 0 7 0 0 0 0 0 7 0 0 0 0 0 0 0 0 0 4 4 0 0 0 4 0 0 4 0 0 0 0 0 0 0 0 2 0 0 4 4
7 7 7 7 7 7 7 7 7 7 7 0 0 0 0 0 0 0 0 0 4 4 0 0 0 4 0 0 4 0 0 0 0 2 2 2 2 2 0 0 4 4
6 6 0 0 0 0 0 0 0 0 7 0 0 0 0 0 0 0 0 0 4 4 0 0 0 4 4 4 4 4 4 0 0 2 0 0 0 0 0 0 4 4
1 6 0 0 0 0 0 0 0 0 7 0 0 0 9 9 0 0 0 0 4 4 0 0 0 0 0 0 4 0 0 0 0 2 0 0 0 0 0 0 4 4
1 6 0 0 6 0 0 0 0 0 0 0 0 0 9 9 0 0 0 0 4 4 0 0 0 0 0 0 4 0 0 0 0 2 2 2 2 2 0 0 4 4
1 6 0 0 6 0 0 0 0 0 0 0 0 0 9 9 0 0 0 0 0 0 0 0 0 0 0 0 0 0 0 0 0 0 0 0 0 0 0 0 4 4
1 6 0 0 6 0 0 0 0 0 0 0 0 0 9 9 0 0 0 0 4 4 4 4 4 4 4 4 4 4 4 4 4 4 4 4 4 4 0 0 4 4
1 6 0 0 6 6 6 6 6 6 6 6 6 6 1 1 1 1 1 1 1 1 1 1 1 1 1 1 1 1 1 1 1 1 1 1 1 1 0 0 1 1
1 6 0 0 6 6 10 10 10 10 10 10 6 6 0 0 0 0 0 0 0 0 0 0 0 0 0 0 0 0 0 0 1 0 0 0 0 0 0 0 1 1
1 6 0 0 6 6 0 0 0 0 0 0 6 6 0 0 0 0 0 0 0 0 0 0 0 0 0 0 0 0 0 0 1 0 0 0 0 0 0 0 1 1
1 6 0 0 6 6 0 0 0 0 0 0 6 6 0 0 0 0 0 0 0 0 0 0 0 0 0 0 0 0 0 0 1 0 0 0 0 0 0 0 1 1
1 6 0 0 0 0 0 0 0 0 0 0 0 0 0 0 2 2 0 0 2 2 0 0 0 1 1 1 1 1 1 1 1 0 0 0 1 0 0 0 1 1
1 6 0 0 0 0 0 0 0 0 0 0 0 0 0 0 2 0 0 0 0 2 0 0 0 1 1 1 1 1 1 1 1 0 0 0 1 0 0 0 1 1
1 6 6 6 6 6 6 6 6 6 6 6 6 0 0 0 2 0 0 0 0 2 0 0 0 1 1 0 0 0 0 0 1 0 0 0 1 0 0 0 1 1
1 1 11 1 1 1 1 1 1 1 1 1 1 0 0 0 2 2 2 2 2 2 0 0 0 1 1 0 0 0 0 0 0 0 0 0 1 0 0 0 1 1
1 1 0 0 1 0 0 0 0 0 0 0 0 0 0 0 0 0 0 0 0 0 0 0 0 0 0 0 0 0 0 0 0 0 0 0 1 0 0 0 1 1
1 1 0 0 1 0 0 0 0 0 0 0 0 0 0 0 0 0 0 0 0 0 0 0 0 0 0 0 0 0 0 0 1 0 0 0 1 0 0 0 1 1
1 1 0 0 1 1 1 1 1 1 1 1 1 1 1 1 -1 1 1 1 1 1 1 1 1 1 1 1 1 1 1 1 1 0 0 0 1 0 0 0 1 1
1 1 0 0 1 0 0 0 0 0 0 0 0 0 0 0 0 0 0 0 0 0 0 0 0 0 0 0 0 0 0 0 0 0 0 0 1 1 1 1 1 1
1 1 0 0 1 0 0 0 0 0 0 0 0 0 0 0 0 0 0 0 0 0 0 0 0 0 0 0 0 0 0 0 0 0 0 0 0 0 0 0 1 1
1 1 0 0 1 0 0 0 0 0 0 0 0 0 0 0 0 0 0 0 0 0 0 0 0 0 0 0 0 0 0 0 0 0 0 0 0 0 0 0 1 1
1 1 0 0 1 0 0 0 0 0 0 0 0 0 0 0 0 0 0 0 0 0 0 0 0 0 0 0 0 0 0 0 1 1 1 1 1 0 0 0 1 1
1 1 0 0 1 1 1 1 1 0 0 0 1 1 1 1 0 0 0 1 1 1 1 0 0 0 0 0 0 0 0 0 0 0 0 1 1 0 0 0 1 1
1 1 0 0 1 1 0 0 0 0 0 0 0 0 0 1 0 0 0 1 0 0 1 0 0 0 0 0 0 0 0 0 0 0 0 1 1 0 0 0 1 1
1 1 0 0 1 1 0 0 0 0 0 0 0 0 0 1 0 0 0 1 0 0 1 1 1 1 1 1 1 1 1 1 1 0 0 1 1 0 0 0 1 1
1 1 0 0 0 0 0 0 0 9 9 9 0 0 0 1 0 0 0 1 0 0 1 1 1 0 0 0 1 0 0 0 0 0 0 1 1 0 0 0 1 1
1 1 0 0 0 0 0 0 0 9 9 9 0 0 0 1 0 0 0 1 0 0 0 0 0 0 0 0 1 0 0 0 0 0 0 1 1 0 0 0 1 1
1 1 0 0 1 1 0 0 0 9 9 9 0 0 0 1 0 0 0 1 0 0 0 0 0 0 1 0 0 0 0 0 0 0 0 1 1 0 0 0 1 1
1 1 0 0 1 1 0 0 0 9 9 9 0 0 0 1 0 0 0 1 0 0 0 0 0 0 1 0 0 0 0 0 0 0 0 1 1 0 0 0 1 1
1 1 1 1 1 1 1 1 1 1 1 1 1 1 1 1 1 1 1 1 1 1 1 1 1 1 1 1 1 1 1 1 1 1 1 1 1 1 1 1 1 1
1 1 1 1 1 1 1 1 1 1 1 1 1 1 1 1 1 1 1 1 1 1 1 1 1 1 1 1 1 1 1 1 1 1 1 1 1 1 1 1 1 1
